111111111111
100000000001
100011110001
111111110N01
111111110001
111111111111